#### NOUNS ####
fok: word
fux: fur
fix: fire
xin: planet/world
xinek: Earth
sak: earth
nak: air
mok: water
fum: food
pok: dog
tak: parent
tok: person, human
mak: machine
kit: cat
kan: language
kon: container
mik: lamp
xi: number
sot: stone
kasot: cobblestone
kanisot: gem
tiku: title
sakun: screen
tokat: list
patin: player


#### MATH ####
xoko: 0
xoku: 1
xuko: 2
xuku: 3
xiko: 4
xiku: 5
xako: 6
xaku: 7
xoka: 8
xoki: 9

toxu: thousand
moxu: million
poxu: billion

oto: decimal point
puto: +
tuko: -
mono: *
xono: /
uko: =


#### ADJECTIVES ####
ki: simple
fu: understandable
ta: smart
fo: free (price)
fi: free (freedom)
ka: broken
amik: alive
kani: shiny
pati: beautiful
xok: real
kox: imaginary


#### COLORS ####
fe: red
ke: orange
pe: yellow
te: green
xe: blue
se: violet

pif: black
fip: white

tan: transparent/translucent
nat: opaque

fiptan: uncolored

#### VERBS ####
komput: to compute
kinof: to flow
fup: to understand
xitun: to lie (horizontal position)
xaton: to rest
xotan: to sit
mokan: to walk
nik: to like
nuk: to look
ami: to live
fexu: to feel


#### OTHER ####
taka: when
taku: where
taki: what/why
akuf: anyone (anybody)
akaf: everyone (everybody)
akif: no-one (nobody)
uf: anything
af: everything
if: nothing
ufi: here
ifu: there
mot: more
tom: less
pik: big
kip: little
anok: true
kona: false
foxad: forward
poxad: backward
foxan: after
poxan: before
tat: that
tit: this
at: at
an: and
os: or
nato: to
otan: from
nei: no
kuo: yes
oko: maybe
kut: but
kuto: thanks
otok: goodbye
ukut: hello, welcome
uko: up
oku: down
mon: left
nom: right
unak: until
xuno: ok, done
kanuso: cancel
